AatII	GACGTC
Acc65I	GGTACC
AccI	GTMKAC
AclI	AACGTT
AatII 	GACGTC
Acc65I	GGTACC
AccI	GTMKAC
AclI	AACGTT
AfeI	AGCGCT
AflII 	CTTAAG
AgeI 	ACCGGT
ApaI 	GGGCCC
ApaLI 	GTGCAC
ApoI	RAATTY
AscI	GGCGCGCC
AseI 	ATTAAT
AsiSI	GCGATCGC
AvrII	CCTAGG
BamHI 	GGATCC
BclI 	TGATCA
BglII 	AGATCT
Bme1580I	GKGCMC
BmtI	GCTAGC
BsaHI	GRCGYC
BsiEI	CGRYCG
BsiWI	CGTACG
BspEI	TCCGGA
BspHI	TCATGA
BsrGI	TGTACA
BssHII	GCGCGC
BstBI 	TTCGAA
BstZ17I	GTATAC
BtgI	CCRYGG
ClaI 	ATCGAT
DraI 	TTTAAA
EaeI	YGGCCR
EagI 	CGGCCG
EcoRI 	GAATTC
EcoRV 	GATATC
FseI	GGCCGGCC
FspI 	TGCGCA
HaeII	RGCGCY
HincII	GTYRAC
HindIII 	AAGCTT
HpaI 	GTTAAC
KasI	GGCGCC
KpnI 	GGTACC
MfeI	CAATTG
MluI	ACGCGT
MscI 	TGGCCA
MspA1I	CMGCKG
MfeI	CAATTG
MluI	ACGCGT
MscI 	TGGCCA
MspA1I	CMGCKG
NaeI	GCCGGC
NarI 	GGCGCC
NcoI 	CCATGG
NdeI 	CATATG
NgoMIV	GCCGGC
NheI 	GCTAGC
NotI 	GCGGCCGC
NruI 	TCGCGA
NsiI	ATGCAT
NspI	RCATGY
PacI	TTAATTAA
PciI	ACATGT
PmeI	GTTTAAAC
PmlI 	CACGTG
PsiI	TTATAA
PspOMI	GGGCCC
PstI 	CTGCAG
PvuI	CGATCG
PvuII 	CAGCTG
SacI 	GAGCTC
SacII 	CCGCGG
SalI 	GTCGAC
SbfI	CCTGCAGG
ScaI	AGTACT
SfcI	CTRYAG
SfoI	GGCGCC
SgrAI	CRCCGGYG
SmaI 	CCCGGG
SmlI	CTYRAG
SnaBI	TACGTA
SpeI 	ACTAGT
SphI	GCATGC
SspI	AATATT
StuI 	AGGCCT
SwaI	ATTTAAAT
XbaI 	TCTAGA
XhoI 	CTCGAG
XmaI	CCCGGG
